____####
_##_#__#
###_#_m#
B#m##m##
B#_##__#
###m#_##
###_#_m_
____#___
