____####
_##_#__#
###_#_m#
M#m#####
B#_##__#
###m#_##
###_#_#_
____#___
